111111111111111111111111111111111111111111
111111111111111111111111111111111111111111
111100000000000011111111000000000000011111
1111C11111111C1111111E00000000000000011111
111000000000000000000000000011111111111111
1110000000000000000000P0000000000111111111
111111111111111111111111111111111111111111
111111111111111111111111111111111111111111