1111111111
10ECC000P1
1111111111