1111111111
1C11100P01
1000E000C1
1111111111