111111111111111111111111111111111111111111111111111111111111111111111111111
111111111111111111111111111111111111111111111111111111111111111111111111111
100000000011100000000000000000000000000000000000000000000000000000000000001
1000000000CE0000000000000000000000000000000000000000000000000000000000000P1
111111111111111111111111111111111111111111111111111111111111111111111111111