1111111111
111EPC0001
1111111111