1111111111
10C0E0P001
1111111111
