1111111111
111EPC0011
1111111111