1111111111
11E00C0111
1110000001
1000011101
10000000P1
1111111111
