1111111111
1110001011
1010100011
1110001101
11C0010001
1110000011
11000E0011
1110000011
1P00001111
1111111111