1111111111
1C1110P001
1000E000C1
1111111111