11111111110111111111111111
11111111111111111111111111
11111111111111111111111111
11111PCE000000000000011111
11111111111111111111111111