111111111111111111111111111111111111111111111111111111111111
111110011100011000110011001111111111111111111111111111111111
110000000000000000000000000000000000000000000000000000000111
110000000000000000000000000000000000000000000000000000000E01
110000000000000000001111111111111111111100000000000000111111
110000000000000000001111111111111111111100000000000000111111
110000000000000000001111111111111111111100000000000000111111
110000000000000000001111111111111111111100000000000000111111
110000000000000000001111111111111111111100000000000000111111
110000000000000000001111111111111111111100000000000000111111
110000000000000000001111111111111111111100000000000000111111
110000000000000000001111111111111111111100000000000000111111
110000000000000000001111111111111111111100000000000000111111
110000000000000000001111111111111111111100000000000000111111
110000000000000000001111111111111111111100000000000000111111
110000000000000000001111111111111111111100000000000000111111
110000000000000000001111111111111111111100000000000000111111
110000000000000000001111111111111111111100000000000000111111
110000000000000000001111111111111111111100000000000000111111
110000000000000000001111111111111111111100000000000000111111
110000000000000000001111111111111111111100000000000000111111
110000000000000000001111111111111111111100000000000000111111
110000000000000000001111111111111111111100000000000000111111
110000000000000000001111111111111111111100000000000000111111
110000000000000000001111111111111111111100000000000000111111
110000000000000000001111111111111111111100000000000000111111
11000000000000000000111111111111111111110000000000000C111111
110000000000000000001111111111111111111100000000000000111111
110000000000000000001111111111111111111100000000000000111111
110000000000000000001111111111111111111100000000000000111111
110000000000000000001111111111111111111100000000000000111111
11000000000000000000111111111111111111110000000000000P111111
111111111111111111111111111111111111111111111111111111111111